11111111111111111111
10010000001E00000001
100101011C1111111101
100101C11C1000000001
100111111C1010101011
100000000010101010C1
1C1111111110101010C1
10000000P0001C1C10C1
11111111111111111111