1111111111111
10100001P1001
1C101CC101001
1010111101011
10000000010C1
1E000110CC011
1111111111111